0 0 0 0 0 0 0 0 0 0 0 0 0 0 0 0 0 5 5 0 0 5 5 0 0 0 0 0 0 0 0 0 0 0 0 0 0 0 0 0
0 0 0 0 0 0 0 0 0 0 0 0 0 0 0 0 0 5 5 0 0 5 5 0 0 0 0 0 0 0 0 0 0 0 0 0 0 0 0 0
0 0 3 3 3 3 3 0 0 4 4 0 0 3 3 0 0 3 3 0 0 3 3 0 0 0 3 3 5 5 3 3 5 5 3 3 4 4 0 0
0 0 3 3 3 5 5 0 0 4 4 0 0 3 3 0 0 3 3 0 0 3 3 0 0 0 3 3 5 5 3 3 5 5 3 3 4 4 0 0
0 0 3 3 3 5 5 0 0 6 6 0 0 0 0 0 0 5 5 0 0 5 5 0 0 0 0 0 0 0 3 3 0 0 0 0 6 6 0 0
0 0 3 5 5 5 5 0 0 6 6 0 0 0 0 0 0 5 5 0 0 5 5 0 0 0 0 0 0 0 3 3 0 0 0 0 6 6 0 0
0 0 3 5 5 5 5 0 0 4 4 0 0 3 3 0 0 3 3 0 0 3 3 0 0 0 0 0 0 0 3 3 0 0 0 0 4 4 0 0
0 0 0 0 0 0 0 0 0 4 4 0 0 3 3 0 0 3 3 4 4 3 3 0 0 0 0 0 0 0 3 3 0 0 0 0 4 4 0 0
0 0 0 0 0 0 0 0 0 0 0 0 0 0 0 0 0 3 3 4 4 3 3 0 0 0 0 0 0 0 0 0 0 0 0 0 0 0 0 0
0 0 0 0 0 0 0 0 0 0 0 0 0 0 0 0 0 3 3 0 0 3 3 0 0 0 0 0 0 0 0 0 0 0 0 0 0 0 0 0
0 0 0 0 0 0 0 0 0 0 0 0 0 0 0 0 0 3 3 0 0 3 3 0 0 0 0 0 0 0 0 0 0 0 0 0 0 0 0 0
0 0 0 0 0 0 0 3 3 3 3 0 0 0 0 0 0 0 0 0 0 0 0 0 0 0 0 0 0 3 3 3 3 0 0 0 0 0 0 0
0 0 0 0 0 0 0 3 3 3 3 0 0 0 0 0 0 0 0 0 0 0 0 0 0 0 0 0 0 3 3 3 3 0 0 0 0 0 0 0
5 5 0 0 0 0 0 0 0 0 0 0 0 0 0 0 0 0 0 0 0 0 0 0 0 0 0 0 0 0 0 0 0 0 0 0 0 0 5 5
5 5 0 0 0 0 0 0 0 0 0 0 0 0 0 0 0 0 0 0 0 0 0 0 0 0 0 0 0 0 0 0 0 0 0 0 0 0 5 5
5 5 0 0 0 0 0 3 3 3 3 3 3 0 0 0 0 5 5 5 5 5 5 0 0 0 0 3 3 3 3 3 3 0 0 0 0 0 5 5
5 5 0 0 0 0 0 3 3 3 3 3 3 0 0 0 5 5 5 5 5 5 5 5 0 0 0 3 3 3 3 3 3 0 0 0 0 0 5 5
5 5 5 5 5 5 0 0 0 0 0 3 3 0 0 5 5 6 6 6 6 6 6 5 5 0 0 3 3 0 0 0 0 0 5 5 5 5 5 5
5 5 5 5 5 5 0 0 0 0 0 3 3 0 0 5 5 6 6 6 6 6 6 5 5 0 0 3 3 0 0 0 0 0 5 5 5 5 5 5
0 0 6 6 0 0 0 0 0 0 0 3 3 4 4 5 5 6 6 6 6 6 6 5 5 4 4 3 3 0 0 0 0 0 0 0 6 6 0 0
0 0 6 6 0 0 0 0 0 0 0 3 3 4 4 5 5 6 6 6 6 6 6 5 5 4 4 3 3 0 0 0 0 0 0 0 6 6 0 0
5 5 5 5 5 5 0 0 0 0 0 3 3 0 0 5 5 6 6 6 6 6 6 5 5 0 0 3 3 0 0 0 0 0 5 5 5 5 5 5
5 5 5 5 5 5 0 0 0 0 0 3 3 0 0 5 5 6 6 6 6 6 6 5 5 0 0 3 3 0 0 0 0 0 5 5 5 5 5 5
5 5 0 0 0 0 0 3 3 3 3 3 3 0 0 0 5 5 5 5 5 5 5 5 0 0 0 3 3 3 3 3 3 0 0 0 0 0 5 5
5 5 0 0 0 0 0 3 3 3 3 3 3 0 0 0 0 5 5 5 5 5 5 0 0 0 0 3 3 3 3 3 3 0 0 0 0 0 5 5
5 5 0 0 0 0 0 0 0 0 0 0 0 0 0 0 0 0 0 0 0 0 0 0 0 0 0 0 0 0 0 0 0 0 0 0 0 0 5 5
5 5 0 0 0 0 0 0 0 0 0 0 0 0 0 0 0 0 0 0 0 0 0 0 0 0 0 0 0 0 0 0 0 0 0 0 0 0 5 5
0 0 0 0 0 0 0 3 3 3 3 0 0 0 0 0 0 0 0 0 0 0 0 0 0 0 0 0 0 3 3 3 3 0 0 0 0 0 0 0
0 0 0 0 0 0 0 3 3 3 3 0 0 0 0 0 0 0 0 0 0 0 0 0 0 0 0 0 0 3 3 3 3 0 0 0 0 0 0 0
0 0 0 0 0 0 0 0 0 0 0 0 0 0 0 0 0 3 3 0 0 3 3 0 0 0 0 0 0 0 0 0 0 0 0 0 0 0 0 0
0 0 0 0 4 4 0 0 0 0 5 5 0 0 0 0 0 3 3 0 0 3 3 0 0 5 5 5 5 0 0 0 0 0 3 3 3 3 0 0
0 0 0 0 4 4 0 0 0 0 5 5 0 0 0 0 0 3 3 4 4 3 3 0 0 5 5 5 5 0 0 0 0 0 3 3 3 3 0 0
0 0 0 0 0 0 0 0 0 0 0 0 0 0 0 0 0 3 3 4 4 3 3 0 0 0 0 0 0 0 0 4 0 0 6 6 3 3 0 0
0 0 0 0 0 0 0 0 0 0 0 0 0 0 0 0 0 3 3 0 0 3 3 0 0 0 0 0 0 0 0 4 0 0 6 6 3 3 0 0
0 0 3 3 3 3 0 0 0 0 0 0 0 0 0 0 0 5 5 0 0 5 5 0 0 3 3 6 6 0 0 4 0 0 0 0 0 0 0 0
0 0 3 3 3 3 0 0 0 0 0 0 0 0 0 0 0 5 5 0 0 5 5 0 0 3 3 6 6 0 0 4 0 0 0 0 0 0 0 0
0 0 3 3 3 3 0 0 0 0 4 4 0 0 0 0 0 3 3 0 0 3 3 0 0 3 3 3 3 0 0 0 0 0 5 5 5 5 0 0
0 0 3 3 3 3 0 0 0 0 4 4 0 0 0 0 0 3 3 0 0 3 3 0 0 3 3 3 3 0 0 0 0 0 5 5 5 5 0 0
0 0 0 0 0 0 0 0 0 0 0 0 0 0 0 0 0 5 5 0 0 5 5 0 0 0 0 0 0 0 0 0 0 0 0 0 0 0 0 0
0 0 0 0 0 0 0 0 0 0 0 0 0 0 0 0 0 5 5 0 0 5 5 0 0 0 0 0 0 0 0 0 0 0 0 0 0 0 0 0